Weeknd Quotes

Trilogy
- Rolling Stone: I'm in a life without a home so this recoginition's not enough
- Wicked Games: Get me off of this, I need confidence in myself
- Twenty Eight: I'm so wrong, I'm so wrong, to let you into my home
- Loft Music: They say my brain meltin', And the only thing I'll tell 'em is, I'm living for the present and the future don't exist

Kissland
- Belong to the World: I'm not a fool, I just love that you're dead inside, I'm not a fool, I'm just lifeless too
- Live For: They tryna make me slow down, tryna tell me how to live, I'm about to lose control
- Pretty: There are certain things that I've come to understand, Expectations can kill a simple man

Beauty Behind the Madness
- Often: My god white, he in my pocket, He get me redder than the devil 'tilI go nauseous
- The Hills: I only love it when you touch me, not feel me, When I'm fucked up that's the real me
- Can't Feel My Face: And I know she'll be the death of me, at least we'll both be numb
- Tell Your Friends: They told me not to fall in love, that shit is pointless, Yeah, that shit is pointless


Starboy
- Starboy: Look what you've done, I'm a motherfuckin' starboy
- False Alarm: You love her, but you'll never be enough
- Party Monster: I'm good, I'm good, I'm great, Know it's been a while, now I'm mixing up the drank
- Reminder: Every time you try to forget who I am, I'll be right there to remind you again
- I Feel it Coming: You've been scared of love and what it did to you, You don't have to run, I know what you've been through
- Secrets: You can't be the one, I realize, we're divided

My Dear Melancholy,
- Call Out My Name: I said I didn't feel nothing baby, but I lied
- Wasted Times: If you ain't layin' next to me, I don't wanna wake up
- Privilege: But I'ma drink the pain away, I'll be back to my old ways


After Hours
- Blinding Lights: I been on my own for long enough, Maybe you can show me how to love, maybe
- Heartless: And I'm back to my ways 'cause I'm heartless, All this money and this fame got me heartless
- After Hours: I was runnin' away from facin' reality, Wastin' all of my time of livin' my fantasies
- In Your Eyes: I just pretend that I'm in the dark, I don't regret 'cause my heart can't take a loss
- Until I Bleed Out: And I don't even wanna get high no more, Just want it out of my life








